10000000000000000000000000000000000000000000012
10000000000000000000000000000000000000000000012
10000000000000000000000000000000000000000000012
10000000000000000000000000000000000000000000012
10000000000000000000000000000000000000000000012
10000000000000000000000000000000000001000000012
10000100000000000000000000011111111011111111012
10111100000000000000000000010000000000000001012
10100000000000000000000000010000000000000001012
10100000000000000000000000010000100000010001012
10100000000100000100000000011011111111111011012
10110000000111011100000000010000000000000001012
10000000000001010000000000010000000000000001012
10001000000001010000000000010000001000000001012
10111000000001010000000000011111011111011111012
10100000000001010000000000010000000000000001012
10000000000000000000000000000000000000000000012
10000000000000000000000010000000000000001000012
10111111111111111111111111111011111011111111112
10100000000000000000000000000000000000000000012
10100000000000000000000000000000000000000000012
10000000000001111000000000000000000000000000012
10000000000011111100000000000000000000000000012
11111111111111111111111111111111111111111111112
11111111111111111111111111111111111111111111112