1000000000000000000000000000000000000000000001
1000000000000000000000000000000000000000000001
1000000000000000000000000000000000000000000001
1000000000000000000000000000000000000000000001
1000000011000000000000000000000000000000000001
1001110111101110000000000000000111011110111001
1010000000000001000000000000001000000000000101
1100000000000000100000110000010000000000000011
1000000000000000100000000000010000000000000001
1000000000000000100000000000010000000000000001
1000000000000000100000000000010000000000000001
1011111111111110100000000000011111111011111111
1000000000000000000000000000000000000000000001
1000000000000000000000000000000000000000000001
1001000000000000111111111111110001000000000001
1011000000000000100000000000010001100000000001
1011000000000000100000000000010001110000000001
1111111100111111100000000000010111111111111011
1000000000000000100001111000000000000000000001
1000000000000000100000000000010000000000000001
1000000000000000011000000001100000000000000001
1001000000000000000000000000000000001000000001
1011000000000000000000000000000000011000000001
1111111111111111111111111111111111111111111111
1111111111111111111111111111111111111111111111