1000000000000000000000000000000000000000000001
1000000000000000000000000000000000000000000001
1000000000000000000000000000000000000000000001
1000000000000000000000000000000000000000000001
1000000000000000000000000000000000000000000001
1000000000000000000000000000000000000100000001
1000010000000000000000000001111111101111111101
1011110000000000000000000001000000000000000101
1010000000000000000000000001000000000000000101
1010000000000000000000000001000010000001000101
1010000000010000010000000001101111111111101101
1011000000011101110000000001000000000000000101
1000000000000101000000000001000000000000000101
1000100000000101000000000001000000100000000101
1011100000000101000000000001111101111101111101
1010000000000101000000000001000000000000000101
1000000000000000000000000000000000000000000001
1000000000000000000000001000000000000000100001
1011111111111111111111111111101111101111111111
1010000000000000000000000000000000000000000001
1010000000000000000000000000000000000000000001
1000000000000111100000000000000000000000000001
1000000000001111110000000000000000000000000001
1111111111111111111111111111111111111111111111
1111111111111111111111111111111111111111111111